1111111111111111111111111111111111
1E00W0000000000C10000C000000000001
1010010100100000101001000000010101
1010010010101010001001000000010101
1P00000W0C000C00000W000000000000C1
1111111111111111111111111111111111
