1111111111111
10010000000C1
100C011111001
1000011111001
1000011111001
1P0011E0000C1
1111111111111